AARS	epilepsy_genes
ADRA2B	epilepsy_genes
ALDH7A1	epilepsy_genes
ALG13	epilepsy_genes
ARHGEF9	epilepsy_genes
ARV1	epilepsy_genes
CACNA1A	epilepsy_genes
CACNA1H	epilepsy_genes
CACNB4	epilepsy_genes
CASR	epilepsy_genes
CDKL5	epilepsy_genes
CERS1	epilepsy_genes
CHD2	epilepsy_genes
CHRNA2	epilepsy_genes
CHRNA4	epilepsy_genes
CHRNB2	epilepsy_genes
CLCN2a	epilepsy_genes
CNTN2	epilepsy_genes
CPA6	epilepsy_genes
CSTB	epilepsy_genes
DEPDC5	epilepsy_genes
DNM1	epilepsy_genes
DOCK7	epilepsy_genes
EEF1A2	epilepsy_genes
EFHC1	epilepsy_genes
EPM2A	epilepsy_genes
FGF12	epilepsy_genes
FRRS1L	epilepsy_genes
GABRA1	epilepsy_genes
GABRB1	epilepsy_genes
GABRB3	epilepsy_genes
GABRD	epilepsy_genes
GABRG2	epilepsy_genes
GAL	epilepsy_genes
GNAO1	epilepsy_genes
GOSR2	epilepsy_genes
GPR98	epilepsy_genes
GRIN2A	epilepsy_genes
GRIN2B	epilepsy_genes
GRIN2D	epilepsy_genes
GUF1	epilepsy_genes
HCN1	epilepsy_genes
ITPA	epilepsy_genes
KCNA2	epilepsy_genes
KCNB1	epilepsy_genes
KCNC1	epilepsy_genes
KCNMA1	epilepsy_genes
KCNQ2	epilepsy_genes
KCNQ3	epilepsy_genes
KCNT1	epilepsy_genes
KCTD7	epilepsy_genes
LGI1	epilepsy_genes
LMNB2	epilepsy_genes
NECAP1	epilepsy_genes
NHLRC1	epilepsy_genes
PCDH19	epilepsy_genes
PLCB1	epilepsy_genes
PNPO	epilepsy_genes
PRDM8	epilepsy_genes
PRICKLE1	epilepsy_genes
PRRT2	epilepsy_genes
SCARB2	epilepsy_genes
SCN1A	epilepsy_genes
SCN1B	epilepsy_genes
SCN2A	epilepsy_genes
SCN8A	epilepsy_genes
SCN9A	epilepsy_genes
SCN9Ab	epilepsy_genes
SIK1	epilepsy_genes
SLC12A5	epilepsy_genes
SLC13A5	epilepsy_genes
SLC1A2	epilepsy_genes
SLC25A12	epilepsy_genes
SLC25A22	epilepsy_genes
SLC2A1	epilepsy_genes
SLC6A1	epilepsy_genes
SPTAN1	epilepsy_genes
ST3GAL3	epilepsy_genes
ST3GAL5	epilepsy_genes
STX1B	epilepsy_genes
STXBP1	epilepsy_genes
SZT2	epilepsy_genes
TBC1D24	epilepsy_genes
UBA5	epilepsy_genes
WWOX	epilepsy_genes
AASS	Epilepsy-related_genes 
ABAT	Epilepsy-related_genes 
ABCC8	Epilepsy-related_genes 
ABHD12	Epilepsy-related_genes 
ACADS	Epilepsy-related_genes 
ACADSB	Epilepsy-related_genes 
ACO2	Epilepsy-related_genes 
ACOX1	Epilepsy-related_genes 
ACSF3	Epilepsy-related_genes 
ACTB	Epilepsy-related_genes 
ACTG1	Epilepsy-related_genes 
ACVR1	Epilepsy-related_genes 
ACY1	Epilepsy-related_genes 
ADD3	Epilepsy-related_genes 
ADK	Epilepsy-related_genes 
ADNP	Epilepsy-related_genes 
ADSL	Epilepsy-related_genes 
AFG3L2	Epilepsy-related_genes 
AGL	Epilepsy-related_genes 
AGPS	Epilepsy-related_genes 
AHI1	Epilepsy-related_genes 
AIFM1	Epilepsy-related_genes 
AIMP1	Epilepsy-related_genes 
AKT2	Epilepsy-related_genes 
ALDH18A1	Epilepsy-related_genes 
ALDH4A1	Epilepsy-related_genes 
ALG1	Epilepsy-related_genes 
ALG11	Epilepsy-related_genes 
ALG12	Epilepsy-related_genes 
ALG2	Epilepsy-related_genes 
ALG3	Epilepsy-related_genes 
ALG6	Epilepsy-related_genes 
ALG9	Epilepsy-related_genes 
AMACR	Epilepsy-related_genes 
AMER1	Epilepsy-related_genes 
AMT	Epilepsy-related_genes 
ANK3	Epilepsy-related_genes 
ANKH	Epilepsy-related_genes 
ANO10	Epilepsy-related_genes 
ANOS1	Epilepsy-related_genes 
AP1S2	Epilepsy-related_genes 
AP3D1	Epilepsy-related_genes 
AP4B1	Epilepsy-related_genes 
AP4E1	Epilepsy-related_genes 
AP4S1	Epilepsy-related_genes 
APOPT1	Epilepsy-related_genes 
APP	Epilepsy-related_genes 
ARG1	Epilepsy-related_genes 
ARHGDIA	Epilepsy-related_genes 
ARID1A	Epilepsy-related_genes 
ARID1B	Epilepsy-related_genes 
ARNT2	Epilepsy-related_genes 
ARSA	Epilepsy-related_genes 
ASAH1	Epilepsy-related_genes 
ASNS	Epilepsy-related_genes 
ASXL1	Epilepsy-related_genes 
ATIC	Epilepsy-related_genes 
ATP1A2	Epilepsy-related_genes 
ATP1A3	Epilepsy-related_genes 
ATP5A1	Epilepsy-related_genes 
ATP6AP1	Epilepsy-related_genes 
ATP6AP2	Epilepsy-related_genes 
ATP6V0A2	Epilepsy-related_genes 
ATP7A	Epilepsy-related_genes 
ATPAF2	Epilepsy-related_genes 
ATXN10	Epilepsy-related_genes 
AUH	Epilepsy-related_genes 
AUTS2	Epilepsy-related_genes 
AVPR2	Epilepsy-related_genes 
B3GNT1	Epilepsy-related_genes 
B4GAT1	Epilepsy-related_genes 
BCAP31	Epilepsy-related_genes 
BCKDHA	Epilepsy-related_genes 
BCKDK	Epilepsy-related_genes 
BCL10	Epilepsy-related_genes 
BCS1L	Epilepsy-related_genes 
BMP4	Epilepsy-related_genes 
BOLA3	Epilepsy-related_genes 
BRAF	Epilepsy-related_genes 
BRAT1	Epilepsy-related_genes 
BRCA2	Epilepsy-related_genes 
BRP44L	Epilepsy-related_genes 
BSCL2	Epilepsy-related_genes 
C10orf2	Epilepsy-related_genes 
C12orf57	Epilepsy-related_genes 
C19orf61	Epilepsy-related_genes 
C2orf25	Epilepsy-related_genes 
CACNA1D	Epilepsy-related_genes 
CACNG2	Epilepsy-related_genes 
CAD	Epilepsy-related_genes 
CALM2	Epilepsy-related_genes 
CAMTA1	Epilepsy-related_genes 
CARD9	Epilepsy-related_genes 
CARS2	Epilepsy-related_genes 
CAV3	Epilepsy-related_genes 
CC2D2A	Epilepsy-related_genes 
CCDC88A	Epilepsy-related_genes 
CCM1	Epilepsy-related_genes 
CD59	Epilepsy-related_genes 
CEP164	Epilepsy-related_genes 
CEP290	Epilepsy-related_genes 
CHD8	Epilepsy-related_genes 
CHKB	Epilepsy-related_genes 
CHN1	Epilepsy-related_genes 
CHRDL1	Epilepsy-related_genes 
CLIC2	Epilepsy-related_genes 
CLN3	Epilepsy-related_genes 
CLN5	Epilepsy-related_genes 
CLN6	Epilepsy-related_genes 
CLN8	Epilepsy-related_genes 
CLPB	Epilepsy-related_genes 
CLPP	Epilepsy-related_genes 
CNNM2	Epilepsy-related_genes 
COG4	Epilepsy-related_genes 
COG6	Epilepsy-related_genes 
COG7	Epilepsy-related_genes 
COG8	Epilepsy-related_genes 
COL18A1	Epilepsy-related_genes 
COL3A1	Epilepsy-related_genes 
COL4A1	Epilepsy-related_genes 
COL4A3BP	Epilepsy-related_genes 
COQ2	Epilepsy-related_genes 
COQ4	Epilepsy-related_genes 
COQ6	Epilepsy-related_genes 
COQ8A	Epilepsy-related_genes 
COQ9	Epilepsy-related_genes 
CORO1A	Epilepsy-related_genes 
COX10	Epilepsy-related_genes 
COX6B1	Epilepsy-related_genes 
COX8A	Epilepsy-related_genes 
CPS1	Epilepsy-related_genes 
CPT2	Epilepsy-related_genes 
CRB2	Epilepsy-related_genes 
CRLF1	Epilepsy-related_genes 
CRYAB	Epilepsy-related_genes 
CSF1R	Epilepsy-related_genes 
CSPP1	Epilepsy-related_genes 
CTC1	Epilepsy-related_genes 
CTH	Epilepsy-related_genes 
CTSD	Epilepsy-related_genes 
CTSF	Epilepsy-related_genes 
CUL4B	Epilepsy-related_genes 
CYB5R3	Epilepsy-related_genes 
CYP27B1	Epilepsy-related_genes 
D2HGDH	Epilepsy-related_genes 
DARS2	Epilepsy-related_genes 
DEAF1	Epilepsy-related_genes 
DHCR24	Epilepsy-related_genes 
DHFR	Epilepsy-related_genes 
DHTKD1	Epilepsy-related_genes 
DKC1	Epilepsy-related_genes 
DLD	Epilepsy-related_genes 
DLG3	Epilepsy-related_genes 
DNAJC5	Epilepsy-related_genes 
DNAJC6	Epilepsy-related_genes 
DNM1L	Epilepsy-related_genes 
DNMT1	Epilepsy-related_genes 
DNMT3A	Epilepsy-related_genes 
DOCK6	Epilepsy-related_genes 
DOCK8	Epilepsy-related_genes 
DOLK	Epilepsy-related_genes 
DPAGT1	Epilepsy-related_genes 
DPM1	Epilepsy-related_genes 
DPM2	Epilepsy-related_genes 
DPYD	Epilepsy-related_genes 
DPYS	Epilepsy-related_genes 
DXS423E	Epilepsy-related_genes 
DYNC1H1	Epilepsy-related_genes 
DYRK1A	Epilepsy-related_genes 
EARS2	Epilepsy-related_genes 
EBP	Epilepsy-related_genes 
ECM1	Epilepsy-related_genes 
EFTUD2	Epilepsy-related_genes 
EGF	Epilepsy-related_genes 
EHMT1	Epilepsy-related_genes 
EIF2B1	Epilepsy-related_genes 
ELOVL4	Epilepsy-related_genes 
EPG5	Epilepsy-related_genes 
ERCC6	Epilepsy-related_genes 
ERLIN2	Epilepsy-related_genes 
ETFDH	Epilepsy-related_genes 
ETHE1	Epilepsy-related_genes 
EXT2	Epilepsy-related_genes 
F2	Epilepsy-related_genes 
FADD	Epilepsy-related_genes 
FAM111A	Epilepsy-related_genes 
FAR1	Epilepsy-related_genes 
FARS2	Epilepsy-related_genes 
FASTKD2	Epilepsy-related_genes 
FAT4	Epilepsy-related_genes 
FBXL4	Epilepsy-related_genes 
FGD1	Epilepsy-related_genes 
FGF8	Epilepsy-related_genes 
FGFR2	Epilepsy-related_genes 
FGFR3	Epilepsy-related_genes 
FKTN	Epilepsy-related_genes 
FMN2	Epilepsy-related_genes 
FMR1	Epilepsy-related_genes 
FOLR1	Epilepsy-related_genes 
FOXG1	Epilepsy-related_genes 
FOXRED1	Epilepsy-related_genes 
FTL	Epilepsy-related_genes 
FTO	Epilepsy-related_genes 
FTSJ1	Epilepsy-related_genes 
GAD1	Epilepsy-related_genes 
GALC	Epilepsy-related_genes 
GAMT	Epilepsy-related_genes 
GATA6	Epilepsy-related_genes 
GATAD2B	Epilepsy-related_genes 
GBA	Epilepsy-related_genes 
GCH1	Epilepsy-related_genes 
GCK	Epilepsy-related_genes 
GDI1	Epilepsy-related_genes 
GFAP	Epilepsy-related_genes 
GFM1	Epilepsy-related_genes 
GJC2	Epilepsy-related_genes 
GK	Epilepsy-related_genes 
GLDC	Epilepsy-related_genes 
GLI2	Epilepsy-related_genes 
GLRA1	Epilepsy-related_genes 
GLUL	Epilepsy-related_genes 
GLYCTK	Epilepsy-related_genes 
GMPPB	Epilepsy-related_genes 
GNA11	Epilepsy-related_genes 
GNAQ	Epilepsy-related_genes 
GNB1	Epilepsy-related_genes 
GNPAT	Epilepsy-related_genes 
GPHN	Epilepsy-related_genes 
GPSM2	Epilepsy-related_genes 
GPT2	Epilepsy-related_genes 
GPX4	Epilepsy-related_genes 
GRIA3	Epilepsy-related_genes 
GRIK2	Epilepsy-related_genes 
GRIN1	Epilepsy-related_genes 
GRM1	Epilepsy-related_genes 
GRN	Epilepsy-related_genes 
GTPBP3	Epilepsy-related_genes 
GUCY1A3	Epilepsy-related_genes 
GYS1	Epilepsy-related_genes 
HACE1	Epilepsy-related_genes 
HADHA	Epilepsy-related_genes 
HADHB	Epilepsy-related_genes 
HAX1	Epilepsy-related_genes 
HCFC1	Epilepsy-related_genes 
HEPACAM	Epilepsy-related_genes 
HERC2	Epilepsy-related_genes 
HESX1	Epilepsy-related_genes 
HEXA	Epilepsy-related_genes 
HGSNAT	Epilepsy-related_genes 
HIBCH	Epilepsy-related_genes 
HIVEP2	Epilepsy-related_genes 
HMGCS2	Epilepsy-related_genes 
HNF1B	Epilepsy-related_genes 
HSD17B10	Epilepsy-related_genes 
HSD17B4	Epilepsy-related_genes 
HSPD1	Epilepsy-related_genes 
HTT	Epilepsy-related_genes 
IDH2	Epilepsy-related_genes 
IDS	Epilepsy-related_genes 
IFIH1	Epilepsy-related_genes 
IFNAR2	Epilepsy-related_genes 
IL1RAPL1	Epilepsy-related_genes 
INSR	Epilepsy-related_genes 
IQSEC2	Epilepsy-related_genes 
IRF3	Epilepsy-related_genes 
ISG15	Epilepsy-related_genes 
ITPR1	Epilepsy-related_genes 
JAM3	Epilepsy-related_genes 
KAT6A	Epilepsy-related_genes 
KCNA1	Epilepsy-related_genes 
KCNH1	Epilepsy-related_genes 
KCNJ10	Epilepsy-related_genes 
KCNJ11	Epilepsy-related_genes 
KCNJ5	Epilepsy-related_genes 
KCNJ6	Epilepsy-related_genes 
KCNQ1	Epilepsy-related_genes 
KDM5C	Epilepsy-related_genes 
KIAA0442	Epilepsy-related_genes 
KIF1A	Epilepsy-related_genes 
KIF4A	Epilepsy-related_genes 
KMT2A	Epilepsy-related_genes 
KPTN	Epilepsy-related_genes 
KRAS	Epilepsy-related_genes 
KRIT1	Epilepsy-related_genes 
LAMA2	Epilepsy-related_genes 
LARS2	Epilepsy-related_genes 
LIAS	Epilepsy-related_genes 
LMAN2L	Epilepsy-related_genes 
LRP2	Epilepsy-related_genes 
LRPPRC	Epilepsy-related_genes 
LRRK2	Epilepsy-related_genes 
MAF	Epilepsy-related_genes 
MAGEL2	Epilepsy-related_genes 
MAN1B1	Epilepsy-related_genes 
MAOA	Epilepsy-related_genes 
MAPRE2	Epilepsy-related_genes 
MAPT	Epilepsy-related_genes 
MARCA2	Epilepsy-related_genes 
MBD5	Epilepsy-related_genes 
MBTPS2	Epilepsy-related_genes 
MCCC1	Epilepsy-related_genes 
MCCC2	Epilepsy-related_genes 
MCM8	Epilepsy-related_genes 
MECP2	Epilepsy-related_genes 
MED13L	Epilepsy-related_genes 
MED25	Epilepsy-related_genes 
MEF2C	Epilepsy-related_genes 
METTL23	Epilepsy-related_genes 
MFSD8	Epilepsy-related_genes 
MID2	Epilepsy-related_genes 
MKS1	Epilepsy-related_genes 
MLC1	Epilepsy-related_genes 
MLYCD	Epilepsy-related_genes 
MMAA	Epilepsy-related_genes 
MMADHC	Epilepsy-related_genes 
MOCS2	Epilepsy-related_genes 
MOGS	Epilepsy-related_genes 
MPC1	Epilepsy-related_genes 
MPDU1	Epilepsy-related_genes 
MRAP	Epilepsy-related_genes 
MRPS22	Epilepsy-related_genes 
MSX2	Epilepsy-related_genes 
MTFMT	Epilepsy-related_genes 
MTHFR	Epilepsy-related_genes 
MTO1	Epilepsy-related_genes 
MTOR	Epilepsy-related_genes 
MTR	Epilepsy-related_genes 
MYT1L	Epilepsy-related_genes 
NAA10	Epilepsy-related_genes 
NADK2	Epilepsy-related_genes 
NALCN	Epilepsy-related_genes 
NANS	Epilepsy-related_genes 
NARS2	Epilepsy-related_genes 
NAT8L	Epilepsy-related_genes 
NDN (IC)	Epilepsy-related_genes 
NDP	Epilepsy-related_genes 
NDUFA1	Epilepsy-related_genes 
NDUFA2	Epilepsy-related_genes 
NDUFAF3	Epilepsy-related_genes 
NDUFAF6	Epilepsy-related_genes 
NDUFB11	Epilepsy-related_genes 
NDUFS4	Epilepsy-related_genes 
NDUFS8	Epilepsy-related_genes 
NDUFV1	Epilepsy-related_genes 
NF1	Epilepsy-related_genes 
NGLY1	Epilepsy-related_genes 
NHS	Epilepsy-related_genes 
NIN	Epilepsy-related_genes 
NIPA1	Epilepsy-related_genes 
NOD2	Epilepsy-related_genes 
NONO	Epilepsy-related_genes 
NOTCH1	Epilepsy-related_genes 
NPC1	Epilepsy-related_genes 
NPC2	Epilepsy-related_genes 
NRAS	Epilepsy-related_genes 
NRXN1	Epilepsy-related_genes 
NSD1	Epilepsy-related_genes 
NUBPL	Epilepsy-related_genes 
OFD1	Epilepsy-related_genes 
OPLAH	Epilepsy-related_genes 
ORAI1	Epilepsy-related_genes 
OTC	Epilepsy-related_genes 
OTX2	Epilepsy-related_genes 
PAK3	Epilepsy-related_genes 
PARN	Epilepsy-related_genes 
PC	Epilepsy-related_genes 
PDE10A	Epilepsy-related_genes 
PDHA1	Epilepsy-related_genes 
PDHX	Epilepsy-related_genes 
PDSS2	Epilepsy-related_genes 
PDX1	Epilepsy-related_genes 
PET100	Epilepsy-related_genes 
PEX13	Epilepsy-related_genes 
PEX14	Epilepsy-related_genes 
PEX19	Epilepsy-related_genes 
PEX2	Epilepsy-related_genes 
PEX3	Epilepsy-related_genes 
PEX5	Epilepsy-related_genes 
PEX7	Epilepsy-related_genes 
PGAP1	Epilepsy-related_genes 
PGAP2	Epilepsy-related_genes 
PGAP3	Epilepsy-related_genes 
PGK1	Epilepsy-related_genes 
PGM3	Epilepsy-related_genes 
PHF6	Epilepsy-related_genes 
PHGDH	Epilepsy-related_genes 
PIGA	Epilepsy-related_genes 
PIGG	Epilepsy-related_genes 
PIGL	Epilepsy-related_genes 
PIGM	Epilepsy-related_genes 
PIGN	Epilepsy-related_genes 
PIGO	Epilepsy-related_genes 
PIGT	Epilepsy-related_genes 
PIGV	Epilepsy-related_genes 
PIGW	Epilepsy-related_genes 
PIGY	Epilepsy-related_genes 
PLA2G6	Epilepsy-related_genes 
PLP1	Epilepsy-related_genes 
PNPLA8	Epilepsy-related_genes 
POGZ	Epilepsy-related_genes 
POLG	Epilepsy-related_genes 
POLG2	Epilepsy-related_genes 
POLR3B	Epilepsy-related_genes 
POMC	Epilepsy-related_genes 
POMGNT1	Epilepsy-related_genes 
POMK	Epilepsy-related_genes 
POMT1	Epilepsy-related_genes 
POMT2	Epilepsy-related_genes 
PPP2R1A	Epilepsy-related_genes 
PPP2R5D	Epilepsy-related_genes 
PPT1	Epilepsy-related_genes 
PQBP1	Epilepsy-related_genes 
PRKDC	Epilepsy-related_genes 
PRNP	Epilepsy-related_genes 
PRODH	Epilepsy-related_genes 
PROK2	Epilepsy-related_genes 
PROS1	Epilepsy-related_genes 
PSAP	Epilepsy-related_genes 
PSAT1	Epilepsy-related_genes 
PSEN1	Epilepsy-related_genes 
PSEN2	Epilepsy-related_genes 
PSMB8	Epilepsy-related_genes 
PSPH	Epilepsy-related_genes 
PTEN	Epilepsy-related_genes 
PTH	Epilepsy-related_genes 
PUF60	Epilepsy-related_genes 
PURA	Epilepsy-related_genes 
PUS3	Epilepsy-related_genes 
QDPR	Epilepsy-related_genes 
RAB18	Epilepsy-related_genes 
RAB39B	Epilepsy-related_genes 
RAI1	Epilepsy-related_genes 
RANBP2	Epilepsy-related_genes 
RAPSN	Epilepsy-related_genes 
RBM10	Epilepsy-related_genes 
RBP4	Epilepsy-related_genes 
RFT1	Epilepsy-related_genes 
RMND1	Epilepsy-related_genes 
RNASET2	Epilepsy-related_genes 
RNF213	Epilepsy-related_genes 
ROGDI	Epilepsy-related_genes 
RPL10	Epilepsy-related_genes 
RRM2B	Epilepsy-related_genes 
RTN4IP1	Epilepsy-related_genes 
RUBCN	Epilepsy-related_genes 
RYR1	Epilepsy-related_genes 
SACS	Epilepsy-related_genes 
SATB2	Epilepsy-related_genes 
SCO2	Epilepsy-related_genes 
SDHD	Epilepsy-related_genes 
SERPINI1	Epilepsy-related_genes 
SETBP1	Epilepsy-related_genes 
SETD2	Epilepsy-related_genes 
SGCE	Epilepsy-related_genes 
SHANK3	Epilepsy-related_genes 
SHROOM4	Epilepsy-related_genes 
SLC16A1	Epilepsy-related_genes 
SLC17A5	Epilepsy-related_genes 
SLC19A3	Epilepsy-related_genes 
SLC1A3	Epilepsy-related_genes 
SLC1A4	Epilepsy-related_genes 
SLC25A1	Epilepsy-related_genes 
SLC25A15	Epilepsy-related_genes 
SLC25A20	Epilepsy-related_genes 
SLC33A1	Epilepsy-related_genes 
SLC35A2	Epilepsy-related_genes 
SLC35A3	Epilepsy-related_genes 
SLC39A8	Epilepsy-related_genes 
SLC46A1	Epilepsy-related_genes 
SLC6A8	Epilepsy-related_genes 
SLC9A1	Epilepsy-related_genes 
SLC9A6	Epilepsy-related_genes 
SLC9A9	Epilepsy-related_genes 
SMARCA2	Epilepsy-related_genes 
SMARCA4	Epilepsy-related_genes 
SMARCB1	Epilepsy-related_genes 
SMARCE1	Epilepsy-related_genes 
SMC1A	Epilepsy-related_genes 
SMS	Epilepsy-related_genes 
SNRPN	Epilepsy-related_genes 
SNX14	Epilepsy-related_genes 
SOBP	Epilepsy-related_genes 
SOX2	Epilepsy-related_genes 
SOX5	Epilepsy-related_genes 
SPR	Epilepsy-related_genes 
SPTLC2	Epilepsy-related_genes 
SSR4	Epilepsy-related_genes 
STAT1	Epilepsy-related_genes 
STAT2	Epilepsy-related_genes 
STT3A	Epilepsy-related_genes 
STT3B	Epilepsy-related_genes 
SUCLA2	Epilepsy-related_genes 
SYNGAP1	Epilepsy-related_genes 
SYNJ1	Epilepsy-related_genes 
SYP	Epilepsy-related_genes 
SYT14	Epilepsy-related_genes 
TAF1	Epilepsy-related_genes 
TANGO2	Epilepsy-related_genes 
TBCK	Epilepsy-related_genes 
TBP	Epilepsy-related_genes 
TCF4	Epilepsy-related_genes 
TDP1	Epilepsy-related_genes 
TDP2	Epilepsy-related_genes 
TECPR2	Epilepsy-related_genes 
TELO2	Epilepsy-related_genes 
THOC2	Epilepsy-related_genes 
THRB	Epilepsy-related_genes 
TICAM1	Epilepsy-related_genes 
TMEM70	Epilepsy-related_genes 
TMLHE	Epilepsy-related_genes 
TPK1	Epilepsy-related_genes 
TPP1	Epilepsy-related_genes 
TRAF3	Epilepsy-related_genes 
TRAPPC11	Epilepsy-related_genes 
TRAPPC9	Epilepsy-related_genes 
TRPM6	Epilepsy-related_genes 
TTR	Epilepsy-related_genes 
TUBB4A	Epilepsy-related_genes 
TXN2	Epilepsy-related_genes 
UBE2A	Epilepsy-related_genes 
UBE3A	Epilepsy-related_genes 
UNC80	Epilepsy-related_genes 
UPB1	Epilepsy-related_genes 
UQCC2	Epilepsy-related_genes 
USP9X	Epilepsy-related_genes 
VARS2	Epilepsy-related_genes 
VPS11	Epilepsy-related_genes 
WDR45	Epilepsy-related_genes 
XK	Epilepsy-related_genes 
XPNPEP3	Epilepsy-related_genes 
ZC4H2	Epilepsy-related_genes 
ZDHHC15	Epilepsy-related_genes 
ZEB2	Epilepsy-related_genes 
ZFP57	Epilepsy-related_genes 
ZFYVE26	Epilepsy-related_genes 
ZSWIM6	Epilepsy-related_genes 
AMPD2	Neurodevelopment-associated_epilepsy_genes 
ANKLE2	Neurodevelopment-associated_epilepsy_genes 
ARFGEF2	Neurodevelopment-associated_epilepsy_genes 
ARX	Neurodevelopment-associated_epilepsy_genes 
"ASPM, "	Neurodevelopment-associated_epilepsy_genes 
ATN1	Neurodevelopment-associated_epilepsy_genes 
CASK	Neurodevelopment-associated_epilepsy_genes 
"CCDC88C, "	Neurodevelopment-associated_epilepsy_genes 
CDK5a	Neurodevelopment-associated_epilepsy_genes 
CENPE	Neurodevelopment-associated_epilepsy_genes 
CENPJ	Neurodevelopment-associated_epilepsy_genes 
CLP1	Neurodevelopment-associated_epilepsy_genes 
CNTNAP2	Neurodevelopment-associated_epilepsy_genes 
COL4A2	Neurodevelopment-associated_epilepsy_genes 
DCX	Neurodevelopment-associated_epilepsy_genes 
DIAPH1	Neurodevelopment-associated_epilepsy_genes 
EMX2	Neurodevelopment-associated_epilepsy_genes 
ERMARD	Neurodevelopment-associated_epilepsy_genes 
EXOSC3	Neurodevelopment-associated_epilepsy_genes 
FIG4	Neurodevelopment-associated_epilepsy_genes 
FLNA	Neurodevelopment-associated_epilepsy_genes 
GPR56	Neurodevelopment-associated_epilepsy_genes 
HERC1	Neurodevelopment-associated_epilepsy_genes 
IER3IP1	Neurodevelopment-associated_epilepsy_genes 
KATNB1	Neurodevelopment-associated_epilepsy_genes 
KIF11	Neurodevelopment-associated_epilepsy_genes 
KIF2A	Neurodevelopment-associated_epilepsy_genes 
KIF5C	Neurodevelopment-associated_epilepsy_genes 
LAMB1	Neurodevelopment-associated_epilepsy_genes 
LAMC3	Neurodevelopment-associated_epilepsy_genes 
MED17	Neurodevelopment-associated_epilepsy_genes 
MFSD2A	Neurodevelopment-associated_epilepsy_genes 
MPDZ	Neurodevelopment-associated_epilepsy_genes 
NDE1	Neurodevelopment-associated_epilepsy_genes 
NSDHL	Neurodevelopment-associated_epilepsy_genes 
OCLN	Neurodevelopment-associated_epilepsy_genes 
OPHN1	Neurodevelopment-associated_epilepsy_genes 
PAFAH1B1	Neurodevelopment-associated_epilepsy_genes 
PCLO	Neurodevelopment-associated_epilepsy_genes 
PIK3R2	Neurodevelopment-associated_epilepsy_genes 
PLEKHG2 	Neurodevelopment-associated_epilepsy_genes 
PNKP	Neurodevelopment-associated_epilepsy_genes 
"PPP1R15B,"	Neurodevelopment-associated_epilepsy_genes 
PTCH1	Neurodevelopment-associated_epilepsy_genes 
QARS	Neurodevelopment-associated_epilepsy_genes 
RELN	Neurodevelopment-associated_epilepsy_genes 
RTTN	Neurodevelopment-associated_epilepsy_genes 
SASS6	Neurodevelopment-associated_epilepsy_genes 
SEPSECS	Neurodevelopment-associated_epilepsy_genes 
SLC12A6 	Neurodevelopment-associated_epilepsy_genes 
SLC20A2	Neurodevelopment-associated_epilepsy_genes 
SNIP1	Neurodevelopment-associated_epilepsy_genes 
SPATA5	Neurodevelopment-associated_epilepsy_genes 
SRPX2	Neurodevelopment-associated_epilepsy_genes 
STAMBP	Neurodevelopment-associated_epilepsy_genes 
STRADA	Neurodevelopment-associated_epilepsy_genes 
SYN1	Neurodevelopment-associated_epilepsy_genes 
TRMT10A	Neurodevelopment-associated_epilepsy_genes 
TSC1	Neurodevelopment-associated_epilepsy_genes 
TSC2	Neurodevelopment-associated_epilepsy_genes 
TSEN15	Neurodevelopment-associated_epilepsy_genes 
TSEN2	Neurodevelopment-associated_epilepsy_genes 
TSEN54	Neurodevelopment-associated_epilepsy_genes 
TUBA1A	Neurodevelopment-associated_epilepsy_genes 
TUBA8	Neurodevelopment-associated_epilepsy_genes 
TUBB2A	Neurodevelopment-associated_epilepsy_genes 
TUBB2B	Neurodevelopment-associated_epilepsy_genes 
TUBB3	Neurodevelopment-associated_epilepsy_genes 
TUBG1	Neurodevelopment-associated_epilepsy_genes 
VPS53	Neurodevelopment-associated_epilepsy_genes 
WDR62	Neurodevelopment-associated_epilepsy_genes 
WDR73a	Neurodevelopment-associated_epilepsy_genes 
XPR1	Neurodevelopment-associated_epilepsy_genes 
AAAS	Potential_epilepsy-associated_genes
ACMSD	Potential_epilepsy-associated_genes
ACOT7	Potential_epilepsy-associated_genes
ADAM22	Potential_epilepsy-associated_genes
ADORA2A	Potential_epilepsy-associated_genes
AGTR2	Potential_epilepsy-associated_genes
AKT3	Potential_epilepsy-associated_genes
APOE4	Potential_epilepsy-associated_genes
ARHGEF15	Potential_epilepsy-associated_genes
ATP13A2	Potential_epilepsy-associated_genes
ATP6	Potential_epilepsy-associated_genes
ATP6V0C	Potential_epilepsy-associated_genes
ATP8	Potential_epilepsy-associated_genes
ATP8A2	Potential_epilepsy-associated_genes
BDNF	Potential_epilepsy-associated_genes
BMP5	Potential_epilepsy-associated_genes
BRD2	Potential_epilepsy-associated_genes
BRWD3	Potential_epilepsy-associated_genes
BSN	Potential_epilepsy-associated_genes
C16orf62	Potential_epilepsy-associated_genes
C18orf25	Potential_epilepsy-associated_genes
C3	Potential_epilepsy-associated_genes
C7orf55	Potential_epilepsy-associated_genes
CACNA1G	Potential_epilepsy-associated_genes
CACNA2D1	Potential_epilepsy-associated_genes
CACNA2D2	Potential_epilepsy-associated_genes
CALN1	Potential_epilepsy-associated_genes
CBL	Potential_epilepsy-associated_genes
CD46	Potential_epilepsy-associated_genes
CELF4	Potential_epilepsy-associated_genes
CELSR3	Potential_epilepsy-associated_genes
CENPW	Potential_epilepsy-associated_genes
CHD1L	Potential_epilepsy-associated_genes
CHD3	Potential_epilepsy-associated_genes
CHD4	Potential_epilepsy-associated_genes
CHL1	Potential_epilepsy-associated_genes
CHRFAM7A	Potential_epilepsy-associated_genes
CHRNA7	Potential_epilepsy-associated_genes
CHRNB3	Potential_epilepsy-associated_genes
CLCN4	Potential_epilepsy-associated_genes
CLCN6	Potential_epilepsy-associated_genes
CLSTN1	Potential_epilepsy-associated_genes
COL2A1	Potential_epilepsy-associated_genes
COL6A2	Potential_epilepsy-associated_genes
COL6A3	Potential_epilepsy-associated_genes
COX1	Potential_epilepsy-associated_genes
COX3	Potential_epilepsy-associated_genes
CP	Potential_epilepsy-associated_genes
CREBBP	Potential_epilepsy-associated_genes
CRH	Potential_epilepsy-associated_genes
CRHR1	Potential_epilepsy-associated_genes
CSNK1G1	Potential_epilepsy-associated_genes
CTNND2	Potential_epilepsy-associated_genes
CUX1	Potential_epilepsy-associated_genes
CXCR4	Potential_epilepsy-associated_genes
CYP26C1	Potential_epilepsy-associated_genes
CYTB	Potential_epilepsy-associated_genes
DGKD	Potential_epilepsy-associated_genes
DIP2C	Potential_epilepsy-associated_genes
DLG2	Potential_epilepsy-associated_genes
DMBX1	Potential_epilepsy-associated_genes
DMD	Potential_epilepsy-associated_genes
DNM3	Potential_epilepsy-associated_genes
EIF2C4	Potential_epilepsy-associated_genes
EIF3E	Potential_epilepsy-associated_genes
ELMO1	Potential_epilepsy-associated_genes
ENG	Potential_epilepsy-associated_genes
EPHA5	Potential_epilepsy-associated_genes
EPHB2	Potential_epilepsy-associated_genes
ERBB4	Potential_epilepsy-associated_genes
EXOC6B	Potential_epilepsy-associated_genes
FARP2	Potential_epilepsy-associated_genes
FASN	Potential_epilepsy-associated_genes
FBXO28	Potential_epilepsy-associated_genes
FLG	Potential_epilepsy-associated_genes
FLT4	Potential_epilepsy-associated_genes
FSTL5	Potential_epilepsy-associated_genes
GABBR1	Potential_epilepsy-associated_genes
GABBR2	Potential_epilepsy-associated_genes
GABRA6	Potential_epilepsy-associated_genes
GABRB2	Potential_epilepsy-associated_genes
GAS2L2	Potential_epilepsy-associated_genes
GBE1	Potential_epilepsy-associated_genes
GIPC1	Potential_epilepsy-associated_genes
GJD2	Potential_epilepsy-associated_genes
GMEB2	Potential_epilepsy-associated_genes
GRIK1	Potential_epilepsy-associated_genes
GRINA	Potential_epilepsy-associated_genes
GRIP1	Potential_epilepsy-associated_genes
HCK	Potential_epilepsy-associated_genes
HCN2	Potential_epilepsy-associated_genes
HCN4	Potential_epilepsy-associated_genes
HDAC4	Potential_epilepsy-associated_genes
HECW2	Potential_epilepsy-associated_genes
HEG1	Potential_epilepsy-associated_genes
HIP1	Potential_epilepsy-associated_genes
HNRNPH1	Potential_epilepsy-associated_genes
HNRNPU	Potential_epilepsy-associated_genes
HOXD	Potential_epilepsy-associated_genes
HS2ST1	Potential_epilepsy-associated_genes
HSPG2	Potential_epilepsy-associated_genes
HTR1A	Potential_epilepsy-associated_genes
HTR2A	Potential_epilepsy-associated_genes
HUWE1	Potential_epilepsy-associated_genes
IGSF8	Potential_epilepsy-associated_genes
IL10	Potential_epilepsy-associated_genes
IL1B	Potential_epilepsy-associated_genes
IL1RN	Potential_epilepsy-associated_genes
IL27RA	Potential_epilepsy-associated_genes
IL6	Potential_epilepsy-associated_genes
INO80	Potential_epilepsy-associated_genes
INPP4A	Potential_epilepsy-associated_genes
ITGB1BP1	Potential_epilepsy-associated_genes
JRK	Potential_epilepsy-associated_genes
KARS	Potential_epilepsy-associated_genes
KCNAB1	Potential_epilepsy-associated_genes
KCNAB2	Potential_epilepsy-associated_genes
KCNC3	Potential_epilepsy-associated_genes
KCND2	Potential_epilepsy-associated_genes
KCND3	Potential_epilepsy-associated_genes
KCNE1	Potential_epilepsy-associated_genes
KCNH2	Potential_epilepsy-associated_genes
KCNH5	Potential_epilepsy-associated_genes
KCNJ2	Potential_epilepsy-associated_genes
KCNMB3	Potential_epilepsy-associated_genes
KCNN3	Potential_epilepsy-associated_genes
KCNV2	Potential_epilepsy-associated_genes
KCTD3	Potential_epilepsy-associated_genes
KDM6A	Potential_epilepsy-associated_genes
KIAA1456	Potential_epilepsy-associated_genes
KIAA2022	Potential_epilepsy-associated_genes
KIF3C	Potential_epilepsy-associated_genes
KLF13	Potential_epilepsy-associated_genes
KPNA7	Potential_epilepsy-associated_genes
L1CAM	Potential_epilepsy-associated_genes
LOR	Potential_epilepsy-associated_genes
LPHN2	Potential_epilepsy-associated_genes
LRFN5	Potential_epilepsy-associated_genes
MAGI2	Potential_epilepsy-associated_genes
MAN2A2	Potential_epilepsy-associated_genes
MANBA	Potential_epilepsy-associated_genes
MAPK10	Potential_epilepsy-associated_genes
MATN4	Potential_epilepsy-associated_genes
MCM9	Potential_epilepsy-associated_genes
ME2	Potential_epilepsy-associated_genes
MED12	Potential_epilepsy-associated_genes
MLLT3	Potential_epilepsy-associated_genes
MPP7	Potential_epilepsy-associated_genes
MRI1	Potential_epilepsy-associated_genes
MSC	Potential_epilepsy-associated_genes
MTMR11	Potential_epilepsy-associated_genes
MYH14	Potential_epilepsy-associated_genes
MYH6	Potential_epilepsy-associated_genes
MYO9B	Potential_epilepsy-associated_genes
MYOCD	Potential_epilepsy-associated_genes
NAPB	Potential_epilepsy-associated_genes
NCKAP5	Potential_epilepsy-associated_genes
ND1	Potential_epilepsy-associated_genes
ND4	Potential_epilepsy-associated_genes
ND5	Potential_epilepsy-associated_genes
NEB	Potential_epilepsy-associated_genes
NEDD4	Potential_epilepsy-associated_genes
NEDD4L	Potential_epilepsy-associated_genes
NELL1	Potential_epilepsy-associated_genes
NEU1	Potential_epilepsy-associated_genes
NGFRAP1	Potential_epilepsy-associated_genes
NID1	Potential_epilepsy-associated_genes
NIPA2	Potential_epilepsy-associated_genes
NKAIN3	Potential_epilepsy-associated_genes
NLGN1	Potential_epilepsy-associated_genes
NOL11	Potential_epilepsy-associated_genes
NOL3	Potential_epilepsy-associated_genes
NPC1L1	Potential_epilepsy-associated_genes
NPRL2	Potential_epilepsy-associated_genes
NPRL3	Potential_epilepsy-associated_genes
NR2F1	Potential_epilepsy-associated_genes
NRG2	Potential_epilepsy-associated_genes
NRG3	Potential_epilepsy-associated_genes
OCA2	Potential_epilepsy-associated_genes
OPA1	Potential_epilepsy-associated_genes
OPRM1	Potential_epilepsy-associated_genes
OR10H2	Potential_epilepsy-associated_genes
PARK2	Potential_epilepsy-associated_genes
PCDH12	Potential_epilepsy-associated_genes
PCDH15	Potential_epilepsy-associated_genes
PCDH7	Potential_epilepsy-associated_genes
PCDHB13	Potential_epilepsy-associated_genes
PCDHB4	Potential_epilepsy-associated_genes
PCDHG	Potential_epilepsy-associated_genes
PDYN	Potential_epilepsy-associated_genes
PHF8	Potential_epilepsy-associated_genes
PHOX2B	Potential_epilepsy-associated_genes
PIGQ	Potential_epilepsy-associated_genes
PIK3AP1	Potential_epilepsy-associated_genes
PLXNB2	Potential_epilepsy-associated_genes
PMP22	Potential_epilepsy-associated_genes
PNPT1	Potential_epilepsy-associated_genes
PODXL	Potential_epilepsy-associated_genes
PPP1R3C	Potential_epilepsy-associated_genes
PRICKLE2	Potential_epilepsy-associated_genes
PRKX	Potential_epilepsy-associated_genes
PRRC2B	Potential_epilepsy-associated_genes
PTPN23	Potential_epilepsy-associated_genes
RANGAP1	Potential_epilepsy-associated_genes
RAPGEF6	Potential_epilepsy-associated_genes
RB1	Potential_epilepsy-associated_genes
RBFOX1	Potential_epilepsy-associated_genes
RBFOX3	Potential_epilepsy-associated_genes
RBPJ	Potential_epilepsy-associated_genes
RD3	Potential_epilepsy-associated_genes
RFX3	Potential_epilepsy-associated_genes
RORB	Potential_epilepsy-associated_genes
RTN4R	Potential_epilepsy-associated_genes
RYR3	Potential_epilepsy-associated_genes
SCA2	Potential_epilepsy-associated_genes
SCN3A	Potential_epilepsy-associated_genes
SCN4A	Potential_epilepsy-associated_genes
SCN5A	Potential_epilepsy-associated_genes
SCNM1	Potential_epilepsy-associated_genes
SEC24D	Potential_epilepsy-associated_genes
SEMA5B	Potential_epilepsy-associated_genes
SETD5	Potential_epilepsy-associated_genes
SEZ6	Potential_epilepsy-associated_genes
SGK223	Potential_epilepsy-associated_genes
SHANK1	Potential_epilepsy-associated_genes
SKI	Potential_epilepsy-associated_genes
SLC1A1	Potential_epilepsy-associated_genes
SLC25A2	Potential_epilepsy-associated_genes
SLC26A1	Potential_epilepsy-associated_genes
SLC30A3	Potential_epilepsy-associated_genes
SLC4A10	Potential_epilepsy-associated_genes
SLC4A3	Potential_epilepsy-associated_genes
SLC6A3	Potential_epilepsy-associated_genes
SLC6A4	Potential_epilepsy-associated_genes
SLC7A11	Potential_epilepsy-associated_genes
SLC7A6OS	Potential_epilepsy-associated_genes
SLC8A1	Potential_epilepsy-associated_genes
SLCO1B7	Potential_epilepsy-associated_genes
SNAP25	Potential_epilepsy-associated_genes
SON	Potential_epilepsy-associated_genes
SQSTM1	Potential_epilepsy-associated_genes
SRGAP2	Potential_epilepsy-associated_genes
ST5	Potential_epilepsy-associated_genes
ST7	Potential_epilepsy-associated_genes
ST8SIA2	Potential_epilepsy-associated_genes
STK11	Potential_epilepsy-associated_genes
STYXL1	Potential_epilepsy-associated_genes
SUCO	Potential_epilepsy-associated_genes
SV2A	Potential_epilepsy-associated_genes
SVIL	Potential_epilepsy-associated_genes
SYN2	Potential_epilepsy-associated_genes
SYT2	Potential_epilepsy-associated_genes
TAP1	Potential_epilepsy-associated_genes
TBCD	Potential_epilepsy-associated_genes
TBL1XR1	Potential_epilepsy-associated_genes
TENM2	Potential_epilepsy-associated_genes
THAP1	Potential_epilepsy-associated_genes
TK2	Potential_epilepsy-associated_genes
TMEM139	Potential_epilepsy-associated_genes
TNFAIP6	Potential_epilepsy-associated_genes
TNK2	Potential_epilepsy-associated_genes
TOR1A	Potential_epilepsy-associated_genes
TRIM8	Potential_epilepsy-associated_genes
TRMT44	Potential_epilepsy-associated_genes
TRNR1	Potential_epilepsy-associated_genes
TRPM1	Potential_epilepsy-associated_genes
TSNARE1	Potential_epilepsy-associated_genes
TSPAN7	Potential_epilepsy-associated_genes
TSPYL4	Potential_epilepsy-associated_genes
TTN	Potential_epilepsy-associated_genes
TUBA3E	Potential_epilepsy-associated_genes
UBR5	Potential_epilepsy-associated_genes
VPS35	Potential_epilepsy-associated_genes
WDR19	Potential_epilepsy-associated_genes
WHSC1	Potential_epilepsy-associated_genes
YAP1	Potential_epilepsy-associated_genes
YWHAE	Potential_epilepsy-associated_genes
ZBTB18	Potential_epilepsy-associated_genes
ZFYVE20	Potential_epilepsy-associated_genes
ZMYND11	Potential_epilepsy-associated_genes
ZMYND8	Potential_epilepsy-associated_genes
ZNF12	Potential_epilepsy-associated_genes
ZNF182	Potential_epilepsy-associated_genes
ZNF44	Potential_epilepsy-associated_genes